! 0 = grass
! 2 = soil
! 4 = sea
! 6 = rock
! 8 = castle
! 1 = cave
! 3 = mountain
! 5 = forest
! 7 = lava
! 9 = boundary
99999999999999999999
94444400400040004449
94444022222222222449
94402222225222225249
94402235255255252549
94055553555225525449
94052525355025000049
94025522532222222249
94055225523222223249
94440000000000000049
94402200022020202049
94022250000000000049
94025520002002002049
94000000000000000049
94440504466666666649
94405504466660666649
94053504466666666649
94400044446666666649
94444444444444444449
99999999999999999999
